20
20
#########0##########
#*................*#
#..................#
#.#.############.#.#
#.#.############.#.#
#.#.############.#.#
#.#..............#.#
#.#..............#.#
#.#..............#.#
#.#......P.......#.#
#.#..#.......#...#.#
#....#.......#.....#
0....#.......#.....0
#....#.#####.#.....#
#....#.#####.#.....#
#....#.#####.#.....#
#....#.1234..#.....#
#....#.......#.....#
#*................*#
#########0##########